111111111111111111111111111111111
110000000000000000000000000000001
101000000000000000000000000000001
100100000000000000000000000000001
100010000000000000000000000000001
100001000000000000000000000000001
100000100000000000000000000000001
100000010000000000000000000000001
100000001000000000000000000000001
100000000100000000000000000000001
100000000000000000000000000000001
100000000000000000000000000000001
100000000000000000000000000000001
100000000000000000000000000000001
1000000000000000000000000000P0001
100000000000000000000000000000001
111111111111111111111111111111111