1111111111
1000A00001
10T000C001
10000000P1
1222222221