2222222222
2CCCCCCCC2
2CCCCCCCC2
2222TT2222
2CCCCCCCC2
2222CC2222
   2CC2
1112CC2111
1000000001
1000000001
10000000P1
1111111111

