1 1 1 1 1 1 1 1 1 1
1 0 0 0 0 1 2 2 2 2
1 0 0 0 0 1 2 C C 2
1 0 0 P 0 1 2 C C 2
1 0 0 0 0 0 0 A A 2
1 1 1 0 1 1 2 2 2 2
1 T T T T 1 2 0 0 2
1 T T T T 1 2 0 0 2
1 1 1 1 1 1 2 2 2 2